****************************************************************
*E **                      **                  **              *
*  **  ******************  **  **********  **  **********  *****
*  **      **  **          **  **          **              **  *
*  ******  **  **  **************  **************************  *
*          **  **              **  **          **      **      *
*************  **************  **  **  ******  **  **  ******  *
*              **              **          **      **      **  *
*  **************  **************************************  *****
*                  **      **              **              **  *
*  ******************  **  **  **  ******  **  **********  **  *
*              **      **  **  **  **      **  **      **      *
*************  ******  **  **  **  **  ******  **  ******  **  *
*  **      **          **  **  **  **          **  **      **  *
*  **  **  ****** *******  ******  **************  **  ******  *
*      **              **      **  **                  **  **  *
*  **************  **********  **  **  ******************  *****
*  **          **  **      **  **  **                  **      *
*  **  ******  **  **  **  **  **  ******************  ******  *
*      **      **      **          **                        S *
****************************************************************
